R 1000 1000 

NO ./img/wall_1.xpm
SO ./img/wall_2.xpm
WE ./img/wall_3.xpm
EA ./img/wall_4.xpm

S ./img/sprite_1.xpm

F 220,100,0
C 225,30,0

11111111111111111111111111111
10000000001100000000000000001
10110020011100000000000010001
10210000020000000000000010001
101100N0011100000000000010001
10000000001100200111011110001
11110111111111011102200010001
11110111111111011100000010001
11000000110101011101010010001
10000000000000001100200010001
10000000000000001101010010001
11000000110101000000000000001
11110111112101000000000000001
10000000001100000100000010001
10000000000000001010000121001
10000000001000010001010201001
10000000001101000000N00000001
10000000002100000001010000001
11111111111111111111111111111

